----------------------------------------
-oo-oo--oo--oo--oo----------------------
----------------------------------------
ssss--ss--ss--ss--ss-----oo-------------
^^^^^^^^^^^^^^^^^^^^^^Ss----o-----------
SSSSSSSSSSSSSSSSSSSSSSS--gg---oo--------
----------------------------g----oo-----
------------------------------gg----o-oo
-------------------ooo---oo------gg-----
---------------oo--GGG---GGo---o--o---gg
-----------oo--gg----S---S--ooo-oo-oo---
-*-----oo--gg--------S---S--ggg-gg-gg---
-------gg------------SLLLS--------------
GGGGGG^^^^^^^^^^^^^^^SSSSS^^^^^^^^^^^^^^