-----------------------------
-----------------------------
-*-ooo---ooo----ooo----oo-oo-
SSSSSSS-SSSSS--SSSSS--SSSSSSS
ssSSSss-SSsss-SSssssS-ssSSSss
--SSS---SSSSS-ssSSS-----SSS--
--SSS---SSsss-S-sssSS---SSS--
--SSS---SSSSS--SSSSSs---SSS--
-----------------------------
LLLLLLLLLLLLLLLLLLLLLLLLLLLLL